___________XXXXXX_______________________
________XXXXXXXXXX______________________
______XXXXXXXXXXXXXX____________________
____XXXXXXXXXXXXXXXXX___________________
___XXXXXXXXXXXXXXXXXX___________________
__XXXXXXXX__XXXXXXXXXX__________________
__XXXXXX________XXXXXX__________________
__XXXXXX_______XXXXXXX__________________
__XXXXX________XXXXXXXX_________________
XXXXXXX_______XXXXXXXXX_X_______________
XXXXXXXXX_____XXXXXXXXXXX_______________
XXXXXXXXXX_____XXXXXXXXXX_______________
__XXXXXXXX_____XXXXXXXX_________________
__XXXXXXXXX_XXXXXXXXXXX_________________
__XXXXXXXXXXXXXXXXXXXXX_________________
___XXXXXXXXXXXXXXXXXXXX_________________
____XXXXXXXXXXXXXXXXXX__________________
_______XXXXXXX__XXXXXX__________________
________XXX____XXXXXXX__________________
_______________XXXXXXX__________________
_______________XXXXXXX__________________
____XXX________XXXXXX___________________
__XXXXX_____XXXXXXXXX___________________
__XXXXXXX__XXXXXXXXXX___________________
__XXXXXXXXXXXXXXXXX_____________________
__XXXXXXXXXXXXXXXX______________________
___XXXXXXXXXXXXXX_______________________
____XXXXXXXXXXXXX_______________________
________________________________________
________________________________________
________________________________________
________________________________________
________________________________________
________________________________________
________________________________________
________________________________________
________________________________________
________________________________________
________________________________________
________________________________________
