________________XXXXXXXXX_______________
________________XXXXXXXXX_______________
____________XXXXXXXXXXXXXX______________
_________XXXXXXXXXXXXXXXXXXXX___________
_________XXXXXXXXXXXXXXXXXXXX___________
______XXXXXXXXXXXXXXXXXXXXXXXX__________
_____XXXXXXXXXXXXXXXXXXXXXXXXX__________
_____XXXXXXXXXXXXXXXXXXXXXXXXX__________
___XXXXXXXXXXXX___XXXXXXXXXXXXXX________
___XXXXXXXXX___________XXXXXXXXX________
___XXXXXXXXX__________XXXXXXXXXX________
___XXXXXXXXX__________XXXXXXXXXX________
___XXXXXXX____________XXXXXXXXXXX_______
XXXXXXXXXX__________XXXXXXXXXXXXX__X____
XXXXXXXXXX__________XXXXXXXXXXXXX__X____
XXXXXXXXXXXXX_______XXXXXXXXXXXXXXXX____
XXXXXXXXXXXXXXX_______XXXXXXXXXXXXXX____
XXXXXXXXXXXXXXX_______XXXXXXXXXXXXXX____
___XXXXXXXXXXXX_______XXXXXXXXXXX_______
___XXXXXXXXXXXXX__XXXXXXXXXXXXXXX_______
___XXXXXXXXXXXXXXXXXXXXXXXXXXXXXX_______
___XXXXXXXXXXXXXXXXXXXXXXXXXXXXXX_______
_____XXXXXXXXXXXXXXXXXXXXXXXXXXXX_______
______XXXXXXXXXXXXXXXXXXXXXXXXXX________
______XXXXXXXXXXXXXXXXXXXXXXXXXX________
__________XXXXXXXXXX___XXXXXXXXX________
____________XXXX______XXXXXXXXXX________
____________XXXX______XXXXXXXXXX________
______________________XXXXXXXXXX________
______________________XXXXXXXXXX________
______XXXX____________XXXXXXXX__________
______XXXX____________XXXXXXXX__________
___XXXXXXX________XXXXXXXXXXXX__________
___XXXXXXXXXX___XXXXXXXXXXXXXX__________
___XXXXXXXXXX___XXXXXXXXXXXXXX__________
___XXXXXXXXXXXXXXXXXXXXXXXXX____________
___XXXXXXXXXXXXXXXXXXXXXXX______________
___XXXXXXXXXXXXXXXXXXXXXXX______________
_____XXXXXXXXXXXXXXXXXXXX_______________
______XXXXXXXXXXXXXXXXXXX_______________
