__________________XXXXXXXXX_____________
__________________XXXXXXXXX_____________
______________XXXXXXXXXXXXXX____________
___________XXXXXXXXXXXXXXXXXXXX_________
___________XXXXXXXXXXXXXXXXXXXX_________
________XXXXXXXXXXXXXXXXXXXXXXXX________
_______XXXXXXXXXXXXXXXXXXXXXXXXX________
_______XXXXXXXXXXXXXXXXXXXXXXXXX________
_____XXXXXXXXXXXX___XXXXXXXXXXXXXX______
_____XXXXXXXXX___________XXXXXXXXX______
_____XXXXXXXXX__________XXXXXXXXXX______
_____XXXXXXXXX__________XXXXXXXXXX______
_____XXXXXXX____________XXXXXXXXXXX_____
__XXXXXXXXXX__________XXXXXXXXXXXXX__X__
__XXXXXXXXXX__________XXXXXXXXXXXXX__X__
__XXXXXXXXXXXXX_______XXXXXXXXXXXXXXXX__
__XXXXXXXXXXXXXXX_______XXXXXXXXXXXXXX__
__XXXXXXXXXXXXXXX_______XXXXXXXXXXXXXX__
_____XXXXXXXXXXXX_______XXXXXXXXXXX_____
_____XXXXXXXXXXXXX__XXXXXXXXXXXXXXX_____
_____XXXXXXXXXXXXXXXXXXXXXXXXXXXXXX_____
_____XXXXXXXXXXXXXXXXXXXXXXXXXXXXXX_____
_______XXXXXXXXXXXXXXXXXXXXXXXXXXXX_____
________XXXXXXXXXXXXXXXXXXXXXXXXXX______
________XXXXXXXXXXXXXXXXXXXXXXXXXX______
____________XXXXXXXXXX___XXXXXXXXX______
______________XXXX______XXXXXXXXXX______
______________XXXX______XXXXXXXXXX______
________________________XXXXXXXXXX______
________________________XXXXXXXXXX______
________XXXX____________XXXXXXXX________
________XXXX____________XXXXXXXX________
_____XXXXXXX________XXXXXXXXXXXX________
_____XXXXXXXXXX___XXXXXXXXXXXXXX________
_____XXXXXXXXXX___XXXXXXXXXXXXXX________
_____XXXXXXXXXXXXXXXXXXXXXXXXX__________
_____XXXXXXXXXXXXXXXXXXXXXXX____________
_____XXXXXXXXXXXXXXXXXXXXXXX____________
_______XXXXXXXXXXXXXXXXXXXX_____________
________XXXXXXXXXXXXXXXXXXX_____________
